{28,87,39,9,75,46,31,89,7,55},
{78,68,49,48,67,23,38,32,60,62},
{35,33,4,2,74,69,31,89,16,82},
{81,66,91,24,35,52,86,73,13,36},
{75,89,17,13,1,16,34,57,21,47},
{19,54,62,8,22,77,46,36,31,16},
{18,51,71,46,4,72,44,61,90,16},
{20,91,35,95,46,5,81,53,77,55},
{29,6,30,49,71,33,89,71,19,98},
{60,12,93,71,64,64,11,100,50,64},
